# Stage 2 Map  (from sketch: switch+manhole platformer with box shadows)
# B=Box, W=Wall, G=Ground, .=Empty, S=seesaw, R=Spawn, 1=Goal, 3=Light(movable,TAB)
# M=Manhole(up/down platform, starts OFF), X=Switch(step on it to start the manhole)
# world_x = col-2 ; world_z = row ; world_y = (the Y=N below) - 1
# STAGE_2 orientation: back wall = +X col 19 (shadow screen), camera on -X looks +X,
# light on the -X side shines +X. Player progresses high-Z (right start) -> low-Z
# (left goal): use seesaw/boxes + light for shadows, hit the switch to start the
# manhole, ride it. FIRST-CUT from the sketch -- positions need playtest tuning.

# Layer Y=0 (floor)
....................
....GGGGGGGGGGGGGGG.
....GGGGGGGGGGGGGGG.
....GGGGGGGGGGGGGGG.
....GGGGGGGGGGGGGGG.
....GGGGGGGGGGGGGGG.
....GGGGGGGGGGGGGGG.
....GGGGGGGGGGGGGGG.
....GGGGGGGGGGGGGGG.
....GGGGGGGGGGGGGGG.
....GGGGGGGGGGGGGGG.
....GGGGGGGGGGGGGGG.
....GGGGGGGGGGGGGGG.
....GGGGGGGGGGGGGGG.
....GGGGGGGGGGGGGGG.
....GGGGGGGGGGGGGGG.
....GGGGGGGGGGGGGGG.
....GGGGGGGGGGGGGGG.
....GGGGGGGGGGGGGGG.
....................
....................
....................
....................
....................
....................
....................
....................
....................

# Layer Y=1 (world y=0)
WWWWWWWWWWWWWWWWWWWW
...................W
............GGGGGGGW
............GGGGGGGW
............GGGGGGGW
............GGGGGGGW
............GGGGGGGW
............GGGGGGGW
............GGGGGGGW
............GGGGGGGW
............GGGGGGGW
............GGGGGGGW
...................W
...................W
...................W
...................W
...................W
...................W
...................W
...................W
............GGGGGGGW
............GGGGGGGW
............GGGGGGGW
............GGGGGGGW
............GGGGGGGW
............GGGGGGGW
............GGGGGGGW
WWWWWWWWWWWWWWWWWWWW

# Layer Y=2 (world y=1)
WWWWWWWWWWWWWWWWWWWW
...................W
...................W
...............1...W
...................W
...................W
...................W
...................W
...................W
...............B...W
...................W
...................W
...................W
...................W
...................W
............GGGGGGGW
............GGGGGGGW
............GGGGGGGW
...................W
...................W
............GGGGGGGW
............GGGGGGGW
............GGGGGGGW
............GGGGGGGW
............GGGGGGGW
............GGGGGGGW
............GGGGGGGW
WWWWWWWWWWWWWWWWWWWW

# Layer Y=3 (world y=2)
WWWWWWWWWWWWWWWWWWWW
...................W
...................W
...................W
...................W
...................W
...................W
...................W
...................W
...................W
...................W
...................W
...................W
...................W
...................W
...................W
...................W
............GGGGGGGW
............GGGGGGGW
............GGGGGGGW
............GGGGGGGW
............GGGGGGGW
............GGGGGGGW
............GGGGGGGW
..3.........GGGGGGGW
............GGGGGGGW
............GGGGGGGW
WWWWWWWWWWWWWWWWWWWW

# Layer Y=4 (world y=3)
WWWWWWWWWWWWWWWWWWWW
...................W
...................W
...................W
...................W
...................W
...................W
...................W
...................W
............GGGGGG.W
............GGGGGG.W
............GGGGGG.W
............GGGGGG.W
...................W
...................W
...................W
...................W
...................W
...................W
...................W
...................W
.................B.W
...............S...W
...................W
...............R...W
...................W
...................W
WWWWWWWWWWWWWWWWWWWW

# Layer Y=5 (world y=4)
WWWWWWWWWWWWWWWWWWWW
...................W
...................W
...................W
...................W
...................W
...................W
...................W
...................W
...................W
...............B...W
..............X....W
...................W
...................W
...................W
...................W
...................W
...................W
...................W
...................W
...................W
...................W
...................W
...................W
...................W
...................W
...................W
WWWWWWWWWWWWWWWWWWWW

# Layer Y=6 (world y=5)
WWWWWWWWWWWWWWWWWWWW
...................W
...................W
...................W
...................W
...................W
...................W
...................W
...................W
...................W
...................W
...................W
...................W
............GGGGGG.W
............GGGGGG.W
............GGGGGG.W
............GGGGGG.W
...................W
...................W
...................W
...................W
...................W
...................W
...............M...W
...................W
...................W
...................W
WWWWWWWWWWWWWWWWWWWW

# Layer Y=7 (world y=6)
WWWWWWWWWWWWWWWWWWWW
...................W
...................W
...................W
...................W
...................W
...................W
...................W
...................W
...................W
...................W
...................W
...................W
...................W
...............B...W
...................W
...................W
...................W
...................W
...................W
...................W
...................W
...................W
...................W
...................W
...................W
...................W
WWWWWWWWWWWWWWWWWWWW

# Layer Y=8 (world y=7)
WWWWWWWWWWWWWWWWWWWW
...................W
...................W
...................W
...................W
...................W
...................W
...................W
...................W
...................W
...................W
...................W
...................W
...................W
...................W
...................W
...................W
...................W
...................W
...................W
...................W
...................W
...................W
...................W
...................W
...................W
...................W
WWWWWWWWWWWWWWWWWWWW

# Layer Y=9 (world y=8)
WWWWWWWWWWWWWWWWWWWW
...................W
...................W
...................W
...................W
...................W
...................W
...................W
...................W
...................W
...................W
...................W
...................W
...................W
...................W
...................W
...................W
...................W
...................W
...................W
...................W
...................W
...................W
...................W
...................W
...................W
...................W
WWWWWWWWWWWWWWWWWWWW

