# Stage 1Map
# B = Box, W = Wall, G = Ground,. = Empty, L=Light , M=Manhole , S=seesaw, O=wall , 2=Box(shadow)
# R = Spawn(ReSpawn),F=Windmill(Fuusha) ,T = Transparent wall(toumeina kabe), M = Manhole P=Goal
# N = LongBox, K = Teleport, J = KÇ…îÚÇ‘ÇΩÇﬂÇÃèÍèä
# Layer Y=0 (Ground)
GGGEGGGGGGGGGGGGGGGGGGGGGGG
GGGEGGGGGGGGGGGGGGGGGGGGGGG
GGGEGGGGGGGGGGGGGGGGGGGGGGG
GGGEGGGGGGGGGGGGGGGGGGGGGGG
GGGEGGGGGGGGGGGGGGGGGGGGGGG
GGGEGGGGGGGGGGGGGGGGGGGGGGG
GGGEGGGGGGGGGGGGGGGGGGGGGGG
GGGEGGGGGGGGGGGGGGGGGGGGGGG
GGGEGGGGGGGGGGGGGGGGGGGGGGG
GGGEGGGGGGGGGGGGGGGGGGGGGGG
GGGEGGGGGGGGGGGGGGGGGGGGGGG
GGGEGGGGGGGGGGGGGGGGGGGGGGG
GGGEGGGGGGGGGGGGGGGGGGGGGGG
GGGEGGGGGGGGGGGGGGGGGGGGGGG
GGGEGGGGGGGGGGGGGGGGGGGGGGG
GGGEGGGGGGGGGGGGGGGGGGGGGGG
GGGE.......................
GGGE.......................
GGGE.......................
GGGE.......................
GGGE.......................
GGGE.......................
GGGE.......................
GGGGGGGGGGGGGGGGGGGGGGGGGGG
GGGGGGGGGGGGGGGGGGGGGGGGGGG  
GGGGGGGGGGGGGGGGGGGGGGGGGGG
GGGGGGGGGGGGGGGGGGGGGGGGGGG
GGGGGGGGGGGGGGGGGGGGGGGGGGG
GGGGGGGGGGGGGGGGGGGGGGGGGGG
GGGGGGGGGGGGGGGGGGGGGGGGGGG
GGGGGGGGGGGGGGGGGGGGGGGGGGG
GGGGGGGGGGGGGGGGGGGGGGGGGGG
GGGGGGGGGGGGGGGGGGGGGGGGGGG
GGGGGGGGGGGGGGGGGGGGGGGGGGG  
GGGGGGGGGGGGGGGGGGGGGGGGGGG


# Layer Y=1 (Second floor)
EEEEEEEEEEEEEEEEEEEEEEEEEEE
...E......................W
...E......................W
...E......................W
...E......................W
...E....................K.W 
...E......................W
...E......................W
...E......................W 
...E......................W
.J.E......................W
...E......................W
...E......................W 
...E......M...............W 
...E......................W
...E......................W
...E......................W
...E......................W 
...E......................W
...E......................W
...E......................W
...E......................W 
...E......................W 
..........................W
..................S.......W
..........................W 
..........................W
..........................W 
..........................W
.3........................W
...........R..............W
..........................W 
..........................W
EEEEEEEEEEEEEEEEEEEEEEEEEEE

# Layer Y=2 (Second floor)
EEEEEEEEEEEEEEEEEEEEEEEEEEE
...E......................W
...E......................W
...E......................W
...E......................W
...E......................W 
...E......................W
...E......................W
...E......................W 
...E......................W
...E......................W
...E......................W
...E......................W 
...E......................W 
...E......................W
...E......................W
...E......................W
...E......................W 
...E......................W
...E......................W
...E......................W
...E......................W 
...E......................W 
..........................W
..........................W
..........................W 
..........................W
..........................W 
..........................W
..........................W
..........................W
..........................W 
..........................W
EEEEEEEEEEEEEEEEEEEEEEEEEEE

# Layer Y=3 (Second floor)
EEEEEEEEEEEEEEEEEEEEEEEEEEE
...E......................W
...E......................W
...E......................W
...E......................W
...E......................W 
...E......................W
...E......................W
...E......................W 
...E......................W
...E......................W
...E......................W
...E......................W 
...E......................W 
...E......................W
...E......................W
...E......................W
...E......................W 
...E......................W
...E......................W
...E......................W
...E......................W 
...E......................W 
...E......................W
...E......................W
...E......................W 
...E......................W
...E......................W 
...E......................W
...E......................W
...E......................W
...E......................W 
...E......................W
EEEEEEEEEEEEEEEEEEEEEEEEEEE

# Layer Y=4 (Second floor)
EEEEEEEEEEEEEEEEEEEEEEEEEEE
...E....................GGW
...E....................GGW
...E....................GGW
...E....................GGW
...E......................W 
...E......................W
...E......................W
...E......................W 
...E......................W
...E......................W
...E......................W
...E......................W 
...E......................W 
...E......................W
...E......................W
...E......................W
...E......................W 
...E......................W
...E......................W
...E......................W
...E......................W 
...E......................W 
...E......................W
...E......................W
...E......................W 
...E......................W
...E......................W 
...E......................W
...E......................W
...E......................W
...E......................W 
...E......................W
EEEEEEEEEEEEEEEEEEEEEEEEEEE

# Layer Y=5 (Second floor)
EEEEEEEEEEEEEEEEEEEEEEEEEEE
...E......................W
...E.....................1W
...E......................W
...E......................W
...E......................W 
...E......................W
...E......................W
...E......................W 
...E......................W
...E......................W
...E......................W
...E......................W 
...E......................W 
...E......................W
...E......................W
...E......................W
...E......................W 
...E......................W
...E......................W
...E......................W
...E......................W 
...E......................W 
...E......................W
...E......................W
...E......................W 
...E......................W
...E......................W 
...E......................W
...E......................W
...E......................W
...E......................W 
...E......................W
EEEEEEEEEEEEEEEEEEEEEEEEEEE

# Layer Y=6 (Second floor)
EEEEEEEEEEEEEEEEEEEEEEEEEEE
...E......................W
...E......................W
...E......................W
...E......................W
...E......................W 
...E......................W
...E......................W
...E......................W 
...E......................W
...E......................W
...E......................W
...E......................W 
...E......................W 
...E......................W
...E......................W
...E......................W
...E......................W 
...E......................W
...E......................W
...E......................W
...E......................W 
...E......................W 
...E......................W
...E......................W
...E......................W 
...E......................W
...E......................W 
...E......................W
...E......................W
...E......................W
...E......................W 
...E......................W
EEEEEEEEEEEEEEEEEEEEEEEEEEE

# Layer Y=7 (Second floor)
EEEEEEEEEEEEEEEEEEEEEEEEEEE
...E......................W
...E......................W
...E......................W
...E......................W
...E......................W 
...E......................W
...E......................W
...E......................W 
...E......................W
...E......................W
...E......................W
...E......................W 
...E......................W 
...E......................W
...E......................W
...E......................W
...E......................W 
...E......................W
...E......................W
...E......................W
...E......................W 
...E......................W 
...E......................W
...E......................W
...E......................W 
...E......................W
...E......................W 
...E......................W
...E......................W
...E......................W
...E......................W 
...E......................W
EEEEEEEEEEEEEEEEEEEEEEEEEEE

