# Stage 3 Map  (vertical climb)
# B=Box, W=Wall, G=Ground, .=Empty, S=seesaw, R=Spawn, 1=Goal, 3=Light(movable,TAB)
# world_x = col-2 ; world_z = row ; world_y = (the Y=N below) - 1
# Side-view vertical climb: back wall col 0 (x=-2) is the shadow screen; light on
# the +X side shines -X; camera at +X looks -X and follows the player's HEIGHT.
# Climb the zig-zag ledges (1-step jumps). The layer4->layer7 gap (3 tall) is the
# shadow-climb: ride seesaw / push box + move light so the back-wall shadow lets
# you 2D-climb up to the next ledge. Goal at the top (z=5). First-cut; tune by play.

# Layer Y=0 (floor (world y=-1))
WWWWWWWWWWWW
WGGGGGGGGGG.
WGGGGGGGGGG.
WGGGGGGGGGG.
WGGGGGGGGGG.
WGGGGGGGGGG.
WGGGGGGGGGG.
WGGGGGGGGGG.
WGGGGGGGGGG.
WWWWWWWWWWWW

# Layer Y=1 (world y=0)
WWWWWWWWWWWW
W.GGGGG.....
W.GGGGG.....
W.GGGGG.....
W.GGGGG.....
W...........
W...R.......
W...........
W...........
WWWWWWWWWWWW

# Layer Y=2 (world y=1)
WWWWWWWWWWWW
W...........
W...........
W...........
W...........
W.GGGGG.....
W.GGGGG.....
W.GGGGG.....
W.GGGGG.....
WWWWWWWWWWWW

# Layer Y=3 (world y=2)
WWWWWWWWWWWW
W.GGGGG.....
W.GGGGG.....
W.GGGGG.....
W.GGGGG.....
W...........
W...........
W...........
W...........
WWWWWWWWWWWW

# Layer Y=4 (world y=3)
WWWWWWWWWWWW
W...........
W...........
W...........
W...........
W.GGGGG.....
W.GGGGG.....
W.GGGGG.....
W.GGGGG.....
WWWWWWWWWWWW

# Layer Y=5 (world y=4)
WWWWWWWWWWWW
W...........
W...........
W...........
W...........
W...........
W..S.B......
W...........
W...........
WWWWWWWWWWWW

# Layer Y=6 (world y=5)
WWWWWWWWWWWW
W...........
W...........
W...........
W........3..
W...........
W...........
W...........
W...........
WWWWWWWWWWWW

# Layer Y=7 (world y=6)
WWWWWWWWWWWW
W.GGGGG.....
W.GGGGG.....
W.GGGGG.....
W.GGGGG.....
W...........
W...........
W...........
W...........
WWWWWWWWWWWW

# Layer Y=8 (world y=7)
WWWWWWWWWWWW
W...........
W...........
W...........
W...........
W.GGGGG.....
W.GGGGG.....
W.GGGGG.....
W.GGGGG.....
WWWWWWWWWWWW

# Layer Y=9 (world y=8)
WWWWWWWWWWWW
W.GGGGG.....
W.GGGGG.....
W.GGGGG.....
W.GGGGG.....
W...........
W...........
W...........
W...........
WWWWWWWWWWWW

# Layer Y=10 (world y=9)
WWWWWWWWWWWW
W...........
W...........
W...........
W.GGGGGG....
W.GGGGGG....
W.GGGGGG....
W.GGGGGG....
W.GGGGGG....
WWWWWWWWWWWW

# Layer Y=11 (world y=10)
WWWWWWWWWWWW
W...........
W...........
W...........
W...........
W...1.......
W...........
W...........
W...........
WWWWWWWWWWWW

# Layer Y=12 (world y=11)
WWWWWWWWWWWW
W...........
W...........
W...........
W...........
W...........
W...........
W...........
W...........
WWWWWWWWWWWW

# Layer Y=13 (world y=12)
WWWWWWWWWWWW
W...........
W...........
W...........
W...........
W...........
W...........
W...........
W...........
WWWWWWWWWWWW

