# Stage 1Map  (redesigned)
# B=Box, W=Wall, G=Ground, .=Empty, S=seesaw, 2=Box(shadow), R=Spawn, 1=Goal, 3=Light(movable,TAB)
# world_x = col-2 ; world_z = row ; world_y = (the Y=N below) - 1
# back wall (shadow screen) = col 0 (x=-2); +X side (col 17) OPEN for the camera
# camera sits at x=18..22 looking -X, so no tall wall may stand on the +X side
#
# Intended solution:
#  1) Push box B (+Z) from z=6 to pit edge z=8; its shadow spans the pit
#     (z=9..11, center 2*zBox-zLight=10). 2D on the lit back wall, walk across.
#  2) Cliff z=16..21 (floor->y=4) is too tall to jump; tilt seesaw S (z=13) and
#     move the light so its ramped shadow lets you 2D-climb the back wall.
#  3) Goal at the FAR end of the cliff top (z=20) so the shadow exit is not the win.
#  (pit width + seesaw/light climb positions are first-cut; tune by play.)

# Layer Y=0 (floor / ground - pit at z=9..11)
GGGGGGGGGGGGGGGGGG
GGGGGGGGGGGGGGGGGG
GGGGGGGGGGGGGGGGGG
GGGGGGGGGGGGGGGGGG
GGGGGGGGGGGGGGGGGG
GGGGGGGGGGGGGGGGGG
GGGGGGGGGGGGGGGGGG
GGGGGGGGGGGGGGGGGG
GGGGGGGGGGGGGGGGGG
G................G
G................G
G................G
GGGGGGGGGGGGGGGGGG
GGGGGGGGGGGGGGGGGG
GGGGGGGGGGGGGGGGGG
GGGGGGGGGGGGGGGGGG
GGGGGGGGGGGGGGGGGG
GGGGGGGGGGGGGGGGGG
GGGGGGGGGGGGGGGGGG
GGGGGGGGGGGGGGGGGG
GGGGGGGGGGGGGGGGGG
GGGGGGGGGGGGGGGGGG
GGGGGGGGGGGGGGGGGG

# Layer Y=1 (objects R/B/3/S + cliff base, world y=0)
WWWWWWWWWWWWWWWWWW
W.................
W.................
W.......R.........
W.................
W.................
W.......B.......3.
W.................
W.................
W.................
W.................
W.................
W.................
W........S........
W.................
W.................
WGGGGGGG..........
WGGGGGGG..........
WGGGGGGG..........
WGGGGGGG..........
WGGGGGGG..........
WGGGGGGG..........
WWWWWWWWWWWWWWWWWW

# Layer Y=2 (walls + cliff body, world y=1)
WWWWWWWWWWWWWWWWWW
W.................
W.................
W.................
W.................
W.................
W.................
W.................
W.................
W.................
W.................
W.................
W.................
W.................
W.................
W.................
WGGGGGGG..........
WGGGGGGG..........
WGGGGGGG..........
WGGGGGGG..........
WGGGGGGG..........
WGGGGGGG..........
WWWWWWWWWWWWWWWWWW

# Layer Y=3 (walls + cliff body, world y=2)
WWWWWWWWWWWWWWWWWW
W.................
W.................
W.................
W.................
W.................
W.................
W.................
W.................
W.................
W.................
W.................
W.................
W.................
W.................
W.................
WGGGGGGG..........
WGGGGGGG..........
WGGGGGGG..........
WGGGGGGG..........
WGGGGGGG..........
WGGGGGGG..........
WWWWWWWWWWWWWWWWWW

# Layer Y=4 (walls + cliff body, world y=3)
WWWWWWWWWWWWWWWWWW
W.................
W.................
W.................
W.................
W.................
W.................
W.................
W.................
W.................
W.................
W.................
W.................
W.................
W.................
W.................
WGGGGGGG..........
WGGGGGGG..........
WGGGGGGG..........
WGGGGGGG..........
WGGGGGGG..........
WGGGGGGG..........
WWWWWWWWWWWWWWWWWW

# Layer Y=5 (walls + cliff body, world y=4)
WWWWWWWWWWWWWWWWWW
W.................
W.................
W.................
W.................
W.................
W.................
W.................
W.................
W.................
W.................
W.................
W.................
W.................
W.................
W.................
WGGGGGGG..........
WGGGGGGG..........
WGGGGGGG..........
WGGGGGGG..........
WGGGGGGG..........
WGGGGGGG..........
WWWWWWWWWWWWWWWWWW

# Layer Y=6 (walls + GOAL on cliff top, world y=5)
WWWWWWWWWWWWWWWWWW
W.................
W.................
W.................
W.................
W.................
W.................
W.................
W.................
W.................
W.................
W.................
W.................
W.................
W.................
W.................
W.................
W.................
W.................
W.................
W..1..............
W.................
WWWWWWWWWWWWWWWWWW

# Layer Y=7 (tall shadow-screen walls, world y=6)
WWWWWWWWWWWWWWWWWW
W.................
W.................
W.................
W.................
W.................
W.................
W.................
W.................
W.................
W.................
W.................
W.................
W.................
W.................
W.................
W.................
W.................
W.................
W.................
W.................
W.................
WWWWWWWWWWWWWWWWWW

# Layer Y=8 (tall shadow-screen walls, world y=7)
WWWWWWWWWWWWWWWWWW
W.................
W.................
W.................
W.................
W.................
W.................
W.................
W.................
W.................
W.................
W.................
W.................
W.................
W.................
W.................
W.................
W.................
W.................
W.................
W.................
W.................
WWWWWWWWWWWWWWWWWW

