# Stage 2 Map  (from sketch + solution: fixed light, box-drop bridge)
# B=Box(falls, no rotation), W=Wall, G=Ground, .=Empty, S=seesaw, R=Spawn, 1=Goal
# 3=Light(FIXED in stage2), M=Manhole(up/down, starts OFF), X=Switch(starts manhole)
# world_x = col-2 ; world_z = row ; world_y = (the Y=N below) - 1
# Orientation: +X col19 = shadow wall, camera -X looks +X, light on -X shines +X.
# Solution: push box1 -> climb right high platform (z16-20) -> ride seesaw, 2D on its
# shadow up to the mid-upper platform (z11-14) -> hit switch, drop box2 -> manhole
# (z23) starts; ride its shadow up to the upper-right platform (z24-27), drop box3 ->
# push all 3 boxes into the trench (z4-6) to bridge to the goal (z2). 2 boxes won't
# fill it. FIRST-CUT positions -- shadow climbs + trench width need playtest tuning.

# Layer Y=0 (floor)
....................
............GGGGGGG.
............GGGGGGG.
............GGGGGGG.
............GGGGGGG.
............GGGGGGG.
............GGGGGGG.
............GGGGGGG.
............GGGGGGG.
............GGGGGGG.
............GGGGGGG.
............GGGGGGG.
............GGGGGGG.
............GGGGGGG.
............GGGGGGG.
............GGGGGGG.
....................
....................
....................
....................
....................
....................
....................
....................
....................
....................
....................
....................
....................
....................

# Layer Y=1 (y=0)
WWWWWWWWWWWWWWWWWWWW
............GGGGGGGW
............GGGGGGGW
............GGGGGGGW
...................W
...................W
...................W
............GGGGGGGW
............GGGGGGGW
............GGGGGGGW
............GGGGGGGW
............GGGGGGGW
............GGGGGGGW
............GGGGGGGW
............GGGGGGGW
............GGGGGGGW
............GGGGGGGW
............GGGGGGGW
............GGGGGGGW
............GGGGGGGW
............GGGGGGGW
...................W
...................W
...................W
...................W
...................W
...................W
...................W
...................W
WWWWWWWWWWWWWWWWWWWW

# Layer Y=2 (y=1)
WWWWWWWWWWWWWWWWWWWW
...................W
...............1...W
...................W
...................W
...................W
...................W
...................W
...................W
...................W
...............R...W
...................W
...............B...W
...................W
...................W
...................W
............GGGGGGGW
............GGGGGGGW
............GGGGGGGW
............GGGGGGGW
............GGGGGGGW
...................W
...................W
...................W
...................W
...................W
...................W
...................W
...................W
WWWWWWWWWWWWWWWWWWWW

# Layer Y=3 (y=2)
WWWWWWWWWWWWWWWWWWWW
...................W
...................W
...................W
...................W
...................W
...................W
...................W
...................W
...................W
...................W
...................W
...................W
...................W
...................W
...................W
............GGGGGGGW
............GGGGGGGW
..3.........GGGGGGGW
............GGGGGGGW
............GGGGGGGW
...................W
...................W
...................W
...................W
...................W
...................W
...................W
...................W
WWWWWWWWWWWWWWWWWWWW

# Layer Y=4 (y=3)
WWWWWWWWWWWWWWWWWWWW
...................W
...................W
...................W
...................W
...................W
...................W
...................W
...................W
...................W
...................W
...................W
...................W
...................W
...................W
...................W
...................W
...............S...W
...................W
...................W
...................W
...................W
...................W
...............M...W
...................W
...................W
...................W
...................W
...................W
WWWWWWWWWWWWWWWWWWWW

# Layer Y=5 (y=4)
WWWWWWWWWWWWWWWWWWWW
...................W
...................W
...................W
...................W
...................W
...................W
...................W
...................W
...................W
...................W
............GGGGGG.W
............GGGGGG.W
............GGGGGG.W
............GGGGGG.W
...................W
...................W
...................W
...................W
...................W
...................W
...................W
...................W
...................W
...................W
...................W
...................W
...................W
...................W
WWWWWWWWWWWWWWWWWWWW

# Layer Y=6 (y=5)
WWWWWWWWWWWWWWWWWWWW
...................W
...................W
...................W
...................W
...................W
...................W
...................W
...................W
...................W
...................W
...................W
..............X....W
...............B...W
...................W
...................W
...................W
...................W
...................W
...................W
...................W
...................W
...................W
...................W
............GGGGGG.W
............GGGGGG.W
............GGGGGG.W
............GGGGGG.W
...................W
WWWWWWWWWWWWWWWWWWWW

# Layer Y=7 (y=6)
WWWWWWWWWWWWWWWWWWWW
...................W
...................W
...................W
...................W
...................W
...................W
...................W
...................W
...................W
...................W
...................W
...................W
...................W
...................W
...................W
...................W
...................W
...................W
...................W
...................W
...................W
...................W
...................W
...................W
...............B...W
...................W
...................W
...................W
WWWWWWWWWWWWWWWWWWWW

# Layer Y=8 (y=7)
WWWWWWWWWWWWWWWWWWWW
...................W
...................W
...................W
...................W
...................W
...................W
...................W
...................W
...................W
...................W
...................W
...................W
...................W
...................W
...................W
...................W
...................W
...................W
...................W
...................W
...................W
...................W
...................W
...................W
...................W
...................W
...................W
...................W
WWWWWWWWWWWWWWWWWWWW

# Layer Y=9 (y=8)
WWWWWWWWWWWWWWWWWWWW
...................W
...................W
...................W
...................W
...................W
...................W
...................W
...................W
...................W
...................W
...................W
...................W
...................W
...................W
...................W
...................W
...................W
...................W
...................W
...................W
...................W
...................W
...................W
...................W
...................W
...................W
...................W
...................W
WWWWWWWWWWWWWWWWWWWW

