# Stage 1Map
# B = Box, W = Wall, G = Ground,. = Empty, L=Light , M=Manhole , S=seesaw, O=wall , 2=Box(shadow)
# R = Spawn(ReSpawn),
# Layer Y=0 (Ground)
GGGGGGGGGGGGGGGGGGGG
GGGGGGGGGGGGGGGGGGGG
GGGGGGGGGGGGGGGGGGGG
GGGGGGGGGGGGGGGGGGGG
GGGGGGGGGGGGGGGGGGGG
GGGGGGGGGGGGGGGGGGGG
GGGGGGGGGGGGGGGGGGGG
GGGGGGGGGGGGGGGGGGGG
..................GG
..................GG
..................GG
..................GG
..................GG
GGGGGGGGGGGGGGGGGGGG
GGGGGGGGGGGGGGGGGGGG
GGGGGGGGGGGGGGGGGGGG
GGGGGGGGGGGGGGGGGGGG
GGGGGGGGGGGGGGGGGGGG
GGGGGGGGGGGGGGGGGGGG
GGGGGGGGGGGGGGGGGGGG
GGGGGGGGGGGGGGGGGGGG
GGGGGGGGGGGGGGGGGGGG
GGGGGGGGGGGGGGGGGGGG


# Layer Y=1 (Second floor)
WWWWWWWWWWWWWWWWWW
W.................
W.................
W.................
W.................
W.................
W........S........
W.................
W.................
W.................
W.................
W.................
W.................
W.................
W.................
W.................
W.................
W.................
W.................
W.......B.........
W.................
W.................3
W.......R.........
W.................
WWWWWWWWWWWWWWWWWW


# Layer Y=2 (Second floor)
WWWWWWWWWWWWWWWWWW
W.................
W.................
W.................
W.................
W.................
W.................
W.................
W.................
W.................
W.................
W.................
W.................
W.................
W.................
W.................
W.................
W.................
W.................
W.................
W.................
W.................
W.................
W.................
WWWWWWWWWWWWWWWWWW

# Layer Y=3 (Second floor)
WWWWWWWWWWWWWWWWWW
W.................
W.................
W.................
W.................
W.................
W.................
W.................
W.................
W.................
W.................
W.................
W.................
W.................
W.................
W.................
W.................
W.................
W.................
W.................
W.................
W.................
W.................
W.................
WWWWWWWWWWWWWWWWWW
# Layer Y=4 (Second floor)
WWWWWWWWWWWWWWWWWW
W.................
W.................
W.................
W.................
W.................
W.................
W.................
W.................
W.................
W.................
W.................
W.................
W.................
W.................
W.................
W.................
W.................
W.................
W.................
W.................
W.................
W.................
W.................
WWWWWWWWWWWWWWWWWW

# Layer Y=5 (Second floor)
WWWWWWWWWWWWWWWWWW
W.................
W.................
W.................
W.................
W.................
W.................
W.................
W.................
W.................
W.................
W.................
W.................
W.................
W.................
W.................
W.................
W.................
W.................
WGG...............
WGG...............
WGG...............
WGG...............
WGG...............
WWWWWWWWWWWWWWWWWW

# Layer Y=6 (Second floor)
WWWWWWWWWWWWWWWWWW
W.................
W.................
W.................
W.................
W.................
W.................
W.................
W.................
W.................
W.................
W.................
W.................
W.................
W.................
W.................
W.................
W.................
W.................
W.................
W.................
W1................
W.................
W.................
WWWWWWWWWWWWWWWWWW


# Layer Y=7 (Auto-added: extends walls up)
WWWWWWWWWWWWWWWWWW
W.................
W.................
W.................
W.................
W.................
W.................
W.................
W.................
W.................
W.................
W.................
W.................
W.................
W.................
W.................
W.................
W.................
W.................
W.................
W.................
W.................
W.................
W.................
WWWWWWWWWWWWWWWWWW

# Layer Y=8 (Auto-added: extends walls up)
WWWWWWWWWWWWWWWWWW
W.................
W.................
W.................
W.................
W.................
W.................
W.................
W.................
W.................
W.................
W.................
W.................
W.................
W.................
W.................
W.................
W.................
W.................
W.................
W.................
W.................
W.................
W.................
WWWWWWWWWWWWWWWWWW

# Layer Y=9 (Auto-added: extends walls up)
WWWWWWWWWWWWWWWWWW
W.................
W.................
W.................
W.................
W.................
W.................
W.................
W.................
W.................
W.................
W.................
W.................
W.................
W.................
W.................
W.................
W.................
W.................
W.................
W.................
W.................
W.................
W.................
WWWWWWWWWWWWWWWWWW

# Layer Y=10 (Auto-added: extends walls up)
WWWWWWWWWWWWWWWWWW
W.................
W.................
W.................
W.................
W.................
W.................
W.................
W.................
W.................
W.................
W.................
W.................
W.................
W.................
W.................
W.................
W.................
W.................
W.................
W.................
W.................
W.................
W.................
WWWWWWWWWWWWWWWWWW

# Layer Y=11 (Auto-added: extends walls up)
WWWWWWWWWWWWWWWWWW
W.................
W.................
W.................
W.................
W.................
W.................
W.................
W.................
W.................
W.................
W.................
W.................
W.................
W.................
W.................
W.................
W.................
W.................
W.................
W.................
W.................
W.................
W.................
WWWWWWWWWWWWWWWWWW

# Layer Y=12 (Auto-added: extends walls up)
WWWWWWWWWWWWWWWWWW
W.................
W.................
W.................
W.................
W.................
W.................
W.................
W.................
W.................
W.................
W.................
W.................
W.................
W.................
W.................
W.................
W.................
W.................
W.................
W.................
W.................
W.................
W.................
WWWWWWWWWWWWWWWWWW

# Layer Y=13 (Auto-added: extends walls up)
WWWWWWWWWWWWWWWWWW
W.................
W.................
W.................
W.................
W.................
W.................
W.................
W.................
W.................
W.................
W.................
W.................
W.................
W.................
W.................
W.................
W.................
W.................
W.................
W.................
W.................
W.................
W.................
WWWWWWWWWWWWWWWWWW
